**********************************
*                                *
*  ************                  *
*  *                *            *
*  *               * *           *
*  *              *   *          *
*  *             *     *         *
*  ********     *       *        *
*  *           *         *       *
*  *          *************      *
*  *         *             *     *
*  *        *               *    *
*  *       *                 *   *
*         *                   *  *
*                      O         *
**********************************